1 8 15
###############
#             #
#             #
#             #
#             # 
#             #
#             #
#             #
###############